NO ./textures/1x1_blue.xpm
SO ./textures/1x15_red_white.xpm
WE ./textures/lenu.xpm
EA ./textures/heart.xpm
S ./textures/tonneau.xpm
F 220,100,0
C 225,30,0
        1111111111111111111111111
        1000000000110000000000001
        1011000001110444444444401
        1001044444444444403000001
111111111011000001110000000000001
100000000011000001110111110111111
11110111111111011100000010501
11110111111111011101010014001
11000000110101011100000010001
14444444444444401100000013001
10000000000000001101010010201
11000001110141011111011110N0111
11110111 1110141 101111010001
11111111 1111111 111111111111